11111111111111111111111111111111111111111111111111
10000010000010001000100P00000000000000000000000001
10111110101010111010101000000000000000000000000001
10111110101010111010101000000000000000000000000001
10111110101010111010101000000000000000000000000001
10111110101010111010101000000000000000000000000001
10111110101010111010101000000000000000000000000001
10111110101010111010101000000000000000000000000001
1011111010101011101010100000000000C000000000000001
10111110101010111010101000000000000000000000000001
10111110101010111010101000000000000000000000000001
10111110101010111010101000000000000000000000000001
10111110101010111010101000000000000000000000000001
10111110101010111010101000000000000000000000000001
10111110101010111010101000000000000000000000000001
10111110101010111010101000000000000000000000000001
10111110101010111010100000000000000000000000000001
10001000001000101000000E00000000000000000000000001
11111111111111111111111111111111111111111111111111
