11111111111111111111111111
100P1C10000100000000000001
100000000E0C00000001000111
11111111111111111111111111


