11111111111111111111111111
1110010EC11110000000000001
100P1C10000100000000000001
10000000000000000000000111
10000000000000000000000111
10000000000000000000000111
10000000000000000000000111
10000000000000000000000111
10000000000000000000000111
10000000000000000000000111
10000000000000000000000111
10000000000000000000000111
10000000000000000000000111
10000000000000000000000111
10000000000000000000000111
10000000000000000000000111
11111111111111111111111111